8
1 -1 -1 -1 -1 -1 -1 -1 
0,0 38,0 38,-36 70,-36 70,-2 116,-2 116,34 91,34 91,64 22,64 22,19 0,19
6,0 6,6 14,6 14,0
23,0 23,3 31,3 31,0
62,-18 62,-13 69,-13 69,-18
109,-2 109,8 116,8 116,-2
85,31 85,38 89,38 89,31
70,59 70,64 78,64 78,59
28,59 28,64 34,64 34,58