10
1 -1 -1 -1 -1 -1 -1 -1 -1 -1
0,0 28,0 28,-12 54,-12 54,-17 130,-17 130,0 140,0 140,9 130,9 130,66 43,66 43,87 0,87
0,0 26,0 26,34 0,34
28,-12 54,-12 54,0 28,0
26,0 46,0 46,18 26,18
97,-17 130,-17 130,0 97,0
130,0 140,0 140,9 130,9
88,42 97,42 97,51 88,51
97,59 130,59 130,66 97,66
26,66 43,66 43,87 26,87
0,61 26,61 26,87 0,87