5
1 -1 -1 -1 -1
0,0 0,200 100,200 100,90 200,90 200,170 350,170 350,50 300,50 300,0 200,0 200,-50 50,-50 50,0
60,130 80,130 80,150 60,150
20,40 40,40 40,70 20,70
160,10 180,10 180,25 160,25
260,90 275,90 275,105 260,105