16
1 -1 -1 -1 -1 -1 -1 -1 -1 -1 -1 -1 -1 -1 -1  -1
5,0 63,0 63,28 101,28 101,63 123,63 123,86 118,86 118,94 139,94 139,152 87,152 87,155 0,155 0,37 5,37
5,0 14,0 14,37 5,37
0,46 6,46 6,54 0,54
0,70 5,70 5,81 0,81
0,127 5,127 5,137 0,137 
43,12 51,12 51,21 43,21
45,46 52,46 52,55 45,55
40,63 49,63 49,81 40,81 
16,117 44,117 44,137 16,137
48,146 87,146 87,155 48,155
99,129 127,129 127,137 99,137
71,69 87,69 87,86 71,86
87,69 100,69 100,92 87,92
100,63 118,63 118,103 100,103
118,63 123,63 123,86 118,86
66,132 72,132 72,139 66,139