6
1 -1 -1 -1 -1 -1
0,0 0,200 100,200 100,90 200,90 200,170 350,170 350,50 300,50 300,0 200,0 200,-50 50,-50 50,0
60,130 80,130 80,150 60,150
40,40 60,40 60,55 40,55
130,10 180,10 180,18 130,18
150,-35 170,-35 170,-15 150,-15
240,80 275,80 275,90 240,90